{
  "meta": {
    "id": "7",
    "name": "赌场",
    "width": 100,
    "height": 50,
    "map_type": "building",
    "venue_type": "casino"
  },
  "tile_types": {
    " ": {
      "name": "空白",
      "walkable": false,
      "char": " ",
      "color": "#303030"
    },
    "+": {
      "name": "门",
      "walkable": true,
      "char": "+",
      "color": "#d0a050"
    },
    "1": {
      "name": "石砖地",
      "walkable": true,
      "char": ".",
      "color": "#a09880"
    },
    "#": {
      "name": "石墙",
      "walkable": false,
      "char": "#",
      "color": "#a0a0a0"
    }
  },
  "buildings": {
    "starter_town": {
      "name": "starter_town",
      "doors": [
        [
          51,
          25
        ]
      ]
    }
  },
  "tiles": [
    "                                                                                                    ",
    "                                                                                                    ",
    "                                                                                                    ",
    "                                                                                                    ",
    "                                                                                                    ",
    "                                                                                                    ",
    "                                                                                                    ",
    "                                                                                                    ",
    "                                                                                                    ",
    "                                                                                                    ",
    "                                                                                                    ",
    "                                                                                                    ",
    "                                                                                                    ",
    "                                                                                                    ",
    "                                                                                                    ",
    "                                                                                                    ",
    "                                                                                                    ",
    "                                                                                                    ",
    "                                                                                                    ",
    "                                                                                                    ",
    "                                                                                                    ",
    "                                                                                                    ",
    "                                                                                                    ",
    "                                                                                                    ",
    "                                                                                                    ",
    "               ####################################+#######################                         ",
    "               #1111111111111111111111111111111111111111111111111111111111#                         ",
    "               #1111111111111111111111111111111111111111111111111111111111#                         ",
    "               #1111111111111111111111111111111111111111111111111111111111#                         ",
    "               #1111111111111111111111111111111111111111111111111111111111#                         ",
    "               #1111111111111111111111111111111111111111111111111111111111#                         ",
    "               #1111111111111111111111111111111111111111111111111111111111#                         ",
    "               #1111111111111111111111111111111111111111111111111111111111#                         ",
    "               #1111111111111111111111111111111111111111111111111111111111#                         ",
    "               #1111111111111111111111111111111111111111111111111111111111#                         ",
    "               #1111111111111111111111111111111111111111111111111111111111#                         ",
    "               #1111111111111111111111111111111111111111111111111111111111#                         ",
    "               #1111111111111111111111111111111111111111111111111111111111#                         ",
    "               #1111111111111111111111111111111111111111111111111111111111#                         ",
    "               #1111111111111111111111111111111111111111111111111111111111#                         ",
    "               #1111111111111111111111111111111111111111111111111111111111#                         ",
    "               #1111111111111111111111111111111111111111111111111111111111#                         ",
    "               #1111111111111111111111111111111111111111111111111111111111#                         ",
    "               #1111111111111111111111111111111111111111111111111111111111#                         ",
    "               #1111111111111111111111111111111111111111111111111111111111#                         ",
    "               #1111111111111111111111111111111111111111111111111111111111#                         ",
    "               #1111111111111111111111111111111111111111111111111111111111#                         ",
    "               #1111111111111111111111111111111111111111111111111111111111#                         ",
    "               #1111111111111111111111111111111111111111111111111111111111#                         ",
    "               ############################################################                         "
  ],
  "spawn": [
    50,
    25
  ],
  "signs": [],
  "teleports": [],
  "npcs": []
}