{
  "meta": {
    "id": "town1",
    "name": "小镇",
    "width": 100,
    "height": 50,
    "map_type": "world"
  },
  "tile_types": {
    " ": {
      "name": "空白",
      "walkable": false,
      "char": " ",
      "color": "#303030"
    },
    "+": {
      "name": "门",
      "walkable": true,
      "char": "+",
      "color": "#d0a050"
    },
    "?": {
      "name": "告示牌",
      "walkable": true,
      "char": "?",
      "color": "#b8b8b8"
    },
    "%": {
      "name": "传送点",
      "walkable": true,
      "char": "%",
      "color": "#8a6ab8"
    },
    ".": {
      "name": "草地",
      "walkable": true,
      "char": ".",
      "color": "#5a9a3a",
      "cd_mult": 1.15
    },
    "#": {
      "name": "石墙",
      "walkable": false,
      "char": "#",
      "color": "#a0a0a0"
    }
  },
  "buildings": {
    "road0-1": {
      "name": "road0-1",
      "doors": [
        [
          30,
          25
        ]
      ]
    },
    "11": {
      "name": "11",
      "doors": [
        [
          39,
          28
        ]
      ]
    }
  },
  "tiles": [
    "                                                                                                    ",
    "                                                                                                    ",
    "                                                                                                    ",
    "                                                                                                    ",
    "                                                                                                    ",
    "                                                                                                    ",
    "                                                                                                    ",
    "                                                                                                    ",
    "                                                                                                    ",
    "                                                                                                    ",
    "                              #####################                                                 ",
    "                              #...................#                                                 ",
    "                              #...................#                                                 ",
    "                              #...................#                                                 ",
    "                              #...................#                                                 ",
    "                              #...................#                                                 ",
    "                              #...................#                                                 ",
    "                              #...................#                                                 ",
    "                              #...................#                                                 ",
    "                              #...................#                                                 ",
    "                              #...................#                                                 ",
    "                              #...................#                                                 ",
    "                              #...................#                                                 ",
    "                              #...................#                                                 ",
    "                              #...................#                                                 ",
    "                              +...................###                                               ",
    "                              #.....................#                                               ",
    "                              #.....................#                                               ",
    "                              #.......?+............#                                               ",
    "                              #.....................#                                               ",
    "                              #.....................#                                               ",
    "                              #.......?%............#                                               ",
    "                              #.....................#                                               ",
    "                              #.....................#                                               ",
    "                              #.....................#                                               ",
    "                              #.....................#                                               ",
    "                              #######################                                               ",
    "                                                                                                    ",
    "                                                                                                    ",
    "                                                                                                    ",
    "                                                                                                    ",
    "                                                                                                    ",
    "                                                                                                    ",
    "                                                                                                    ",
    "                                                                                                    ",
    "                                                                                                    ",
    "                                                                                                    ",
    "                                                                                                    ",
    "                                                                                                    ",
    "                                                                                                    "
  ],
  "spawn": [
    50,
    25
  ],
  "signs": [
    {
      "pos": [
        38,
        28
      ],
      "text": "building 11 here"
    },
    {
      "pos": [
        38,
        31
      ],
      "text": "for test"
    }
  ],
  "teleports": [],
  "npcs": []
}